####################
#,,,,,,,,||,,,,,,,,#
#,,,,,,,,||,,,,,,,,#
#,,,,#,,,||,,,#,,,,#
#,,,,#,,,||,,,#,,,,#
#,,,,,,,,||,,,,,,,,#
#,,,,,,,,||,,,,,,,,#
#,,,,,,,,||,,,,,,,,#
#,,,,,,,,||,,,,,,,,#
#,,,,,,,,||,,,,,,,,#
#,,,,,,,,||,,,,,,,,#
#,,,,,,,,||,,,,,,,,#
#,,,,,,,,||,,,,,,,,#
#,,,,,,,,||,,,,,,,,#
#,,,,,,,,||,,,,,,,,#
#,,,,,,,,||,,,,,,,,#
#,,,,,,,,||,,,,,,,,#
#,,,,,,,,||,,,,,,,,#
#,,,,,,,,||,,,,,,,,#
####################